##############
#@...........#
#.#.#######..#
#.#.#.....#..#
#.#.#.###.#..#
#.#...#.E.#..#
#.#.###.#.#..#
#.#.#...#.#E.#
#.#.#.#...#..#
#...#.#E..#..#
#.###.#...#E.#
#.....#...G..#
##############
