##########
#@..#....#
#.#...##.#
#.#...#..#
#.#.###..#
#........#
#.##E###.#
#..#.#...#
#..#...E.#
#.....G..#
##########
##########