##########
#@..#....#
#.#.#.##.#
#.#...#..#
#.#####..#
#........#
#.##E###.#
#..#.#...#
#..#...E.#
#.....G..#
