############
#@..#......#
#.#.#.####.#
#.#........#
#.#####.##.#
#.......#..#
#.#####.#..#
#.#..E..#..#
#.#.#####..#
#...#...E..#
#.#.....G..#
############
